1111111111111
10000010001C1
1100001000001
1E0000P0000C1
1111111111111