1111111111111
10010001000011
1100010E11C011
1C001000000P11
1111111111111