1111111111111111111111111111111111
100P100000000000000000000000000001
1010010100100000101001000000010101
1010010010101010000001000000010101
10000000000000000000000C01111011E1
1111111111111111111111111111111111