1111111111111111111111111111111111
100P00000000000000C000000000000001
101000000000000000C000000000010101
1010000000000000000000000000000001
10000000000000000000000001111010E1
1111111111111111111111111111111111