1111111111111111111111111111111111
1E00000000000000000000000000000001
1010010100100000101001000000010101
101001001010101000P001000000010101
10000000000000000000000C0111111101
1111111111111111111111111111111111