1111111111111111111111111111111111
100P000000000000000000000000000001
1010000000000000000000000000010101
1010000000000000000000000000000001
10000000000C0CCCC000000C01111011E1
1111111111111111111111111111111111