11111111111111111111111111111111111
100P00000000000000C0000000000000011
101000000000000000C0000000000101011
10100000000000000000000000000000011
10000000000000000000000001111010E11
11111111111111111111111111111111111