1111111111111
1001000100001
11000P0000001
10000000ECC01
1111111111111