1111111111111
1001000100001
1100010000001
10000000ECCP1
1111111111111