1111111111111
1001000000001
1000011111C01
100011E0000P1
1111111111111