1111111111111
1001000100001
1100010E11C01
1C001000000P1
1111111111111