1111111111111111111111111111
100000000000P000000000000001
1000000000000000000000000001
100000000000E000000000000001
10000000000C1C00000000000001
1111111111111111111111111111
1111111110111100001111111111
1111111101111101110111111111
1111111000000110000111111111
1111111111011110111111111111
1111111111011110000111111111
1111111111111111111111111111