1111111111111111111111111111
100000000000P000000000000001
1000000000000000000000000001
100000000000E000000000000001
10000000000C1C00000000000001
1111111111111111111111111111
1111111101111110001111111111
1111111101011111110111111111
1111111100000110000111111111
1111111111011110111111111111
1111111111011110000111111111
1111111111111111111111111111