11111111111111111111111111111111111111111
10C000100010001000000000100000100C1000101
10111011101010111111101011101010111110101
10100010100010100010101010001000001010001
11101110111110101110101011111011111011101
1010100000101000001E001000000000000000101
10101010101011101011111110111011101011101
10101010101010001010000000001010101000001
10101011101010111111111011111110111010111
10101010101000001010001000000000100010C01
101C1110101110111011101110111011111011111
1000000000000010000000100010101000001C001
10111110111010101011111010101011111110111
10000010101010101010000010100000001000001
11101111101010111010111111101111111111101
10C000001010100000C0001000100000000000101
11101110101011111011111110111110111110101
10000010001000100010000010100010000010101
11101110101111111011101010101111111010101
1C001000100C000010000010001000000000100P1
11111111111111111111111111111111111111111