111111111
1P00001C1
100000001
111111111
1E0000001
111111111