111111111
1P00001C1
11E000011
111111111