111111111
1P0E00011
1000001C1
111111111