1111111111111
100000C0001C1
1100000000011
1E1000P000001
1111111111111