1111111111111
1001000100001
1100010E11C011
1C001000000P11
1111111111111