1111111111111
1001000100001
1100010011001
1000100000001
1111111111111